1111111111
1CPCE00111
1000000001
1111111111
